██████████████
█░░░░░░░░░░░░█
█░████░█████░█
█░████░█████░█
█░████░█████░█
█░░░░░░░░░░░░░
█░████░██░████
█░████░██░████
█░░░░░░██░░░░█
██████░█████░█
██████░█████░█
██████░██░░░░░
██████░██░███░
██████░██░█░░░
█░░░░░░░░░█░░░
██████░██░█░░░
██████░██░████
██████░██░░░░░
██████░██░████
██████░██░████
█░░░░░░░░░░░░█
█░████░█████░█
█░████░█████░█
█░░░██░░░░░░░░
███░██░██░████
███░██░██░████
█░░░░░░██░░░░█
█░██████████░█
█░██████████░█
█░░░░░░░░░░░░░
██████████████